..................
..................
..................
........O.........
.......OOO........
......OOOOO.......
.......OOO........
........O.........
..................
..................
..................
